#####
#O###
#XXO#
#P###
#####
