##########
#   #    #
#   #    #
#  O     #
#  #### ##
#   #    #
#   #X   #
#        #
#     P  #
##########
