###########
###    #  #
###   X   #
####X###X #
#    OO O##
# ##X#  ###
# #       #
#  P #   O#
###########
