################
##           ###
## #X#######XX #
##OOOO   XOOO  #
## # ########  #
# XX     X  #  #
#  # ###   O# ##
#  #OOO# ##O# ##
####OOO#X # #X##
#   # ## X# #  #
# X #  #   O   #
# XX#  ###P #  #
# X   XX #### ##
#   #  #      ##
################
