    #####             
    #   #             
    #XX #             
  ### X ###           
  #       #           
##### ### #     ######
#   # ### #######   O#
#                   O#
### # #### #P####   O#
  #        ###  ######
  ##########      
    