####################
#              P   #
#      ##    ##    #
#     # #   #  #   #
#    #  #     #    #
#   ######   #     #
#       #   ####   #
#                  #
#                  #
#       X          #
#                  #
#                  #
#     ##           #
#   ##  #          #
#        #####     #
# ##     #   #     #
#        #   #     #
#        #         #
#       O#         #
####################
