#####
#  O#
# X #
#  P#
#####
